//format: implementation method's signature  	  interface method's signature1  ..2 .. if any
org.apache.hadoop.hdfs.server.datanode.DataNode.getBlockLocalPathInfo(Lorg/apache/hadoop/hdfs/protocol/ExtendedBlock;Lorg/apache/hadoop/security/token/Token;)Lorg/apache/hadoop/hdfs/protocol/BlockLocalPathInfo;	org.apache.hadoop.hdfs.protocol.ClientDatanodeProtocol.getBlockLocalPathInfo(Lorg/apache/hadoop/hdfs/protocol/ExtendedBlock;Lorg/apache/hadoop/security/token/Token;)Lorg/apache/hadoop/hdfs/protocol/BlockLocalPathInfo;	
org.apache.hadoop.hdfs.server.datanode.DataNode.initReplicaRecovery(Lorg/apache/hadoop/hdfs/server/protocol/BlockRecoveryCommand$RecoveringBlock;)Lorg/apache/hadoop/hdfs/server/protocol/ReplicaRecoveryInfo;	org.apache.hadoop.hdfs.server.protocol.InterDatanodeProtocol.initReplicaRecovery(Lorg/apache/hadoop/hdfs/server/protocol/BlockRecoveryCommand$RecoveringBlock;)Lorg/apache/hadoop/hdfs/server/protocol/ReplicaRecoveryInfo;	
org.apache.hadoop.hdfs.server.datanode.DataNode.updateReplicaUnderRecovery(Lorg/apache/hadoop/hdfs/protocol/ExtendedBlock;JJ)Lorg/apache/hadoop/hdfs/protocol/ExtendedBlock;	org.apache.hadoop.hdfs.server.protocol.InterDatanodeProtocol.updateReplicaUnderRecovery(Lorg/apache/hadoop/hdfs/protocol/ExtendedBlock;JJ)Lorg/apache/hadoop/hdfs/protocol/ExtendedBlock;	
org.apache.hadoop.hdfs.server.datanode.DataNode.getReplicaVisibleLength(Lorg/apache/hadoop/hdfs/protocol/ExtendedBlock;)J	org.apache.hadoop.hdfs.protocol.ClientDatanodeProtocol.getReplicaVisibleLength(Lorg/apache/hadoop/hdfs/protocol/ExtendedBlock;)J	
org.apache.hadoop.hdfs.server.datanode.DataNode.refreshNamenodes()V	org.apache.hadoop.hdfs.protocol.ClientDatanodeProtocol.refreshNamenodes()V	
org.apache.hadoop.hdfs.server.datanode.DataNode.deleteBlockPool(Ljava/lang/String;Z)V	org.apache.hadoop.hdfs.protocol.ClientDatanodeProtocol.deleteBlockPool(Ljava/lang/String;Z)V	
org.apache.hadoop.hdfs.server.datanode.DataNode.<clinit>()V	org.apache.hadoop.hdfs.server.protocol.InterDatanodeProtocol.<clinit>()V	org.apache.hadoop.hdfs.protocol.ClientDatanodeProtocol.<clinit>()V	
org.apache.hadoop.hdfs.server.namenode.BackupNode$BackupNodeRpcServer.getBlocks(Lorg/apache/hadoop/hdfs/protocol/DatanodeInfo;J)Lorg/apache/hadoop/hdfs/server/protocol/BlocksWithLocations;	org.apache.hadoop.hdfs.server.protocol.NamenodeProtocol.getBlocks(Lorg/apache/hadoop/hdfs/protocol/DatanodeInfo;J)Lorg/apache/hadoop/hdfs/server/protocol/BlocksWithLocations;	
org.apache.hadoop.hdfs.server.namenode.BackupNode$BackupNodeRpcServer.register(Lorg/apache/hadoop/hdfs/server/protocol/NamenodeRegistration;)Lorg/apache/hadoop/hdfs/server/protocol/NamenodeRegistration;	org.apache.hadoop.hdfs.server.protocol.NamenodeProtocol.register(Lorg/apache/hadoop/hdfs/server/protocol/NamenodeRegistration;)Lorg/apache/hadoop/hdfs/server/protocol/NamenodeRegistration;	
org.apache.hadoop.hdfs.server.namenode.BackupNode$BackupNodeRpcServer.startCheckpoint(Lorg/apache/hadoop/hdfs/server/protocol/NamenodeRegistration;)Lorg/apache/hadoop/hdfs/server/protocol/NamenodeCommand;	org.apache.hadoop.hdfs.server.protocol.NamenodeProtocol.startCheckpoint(Lorg/apache/hadoop/hdfs/server/protocol/NamenodeRegistration;)Lorg/apache/hadoop/hdfs/server/protocol/NamenodeCommand;	
org.apache.hadoop.hdfs.server.namenode.BackupNode$BackupNodeRpcServer.endCheckpoint(Lorg/apache/hadoop/hdfs/server/protocol/NamenodeRegistration;Lorg/apache/hadoop/hdfs/server/namenode/CheckpointSignature;)V	org.apache.hadoop.hdfs.server.protocol.NamenodeProtocol.endCheckpoint(Lorg/apache/hadoop/hdfs/server/protocol/NamenodeRegistration;Lorg/apache/hadoop/hdfs/server/namenode/CheckpointSignature;)V	
org.apache.hadoop.hdfs.server.namenode.BackupNode$BackupNodeRpcServer.journal(Lorg/apache/hadoop/hdfs/server/protocol/NamenodeRegistration;JI[B)V	org.apache.hadoop.hdfs.server.protocol.JournalProtocol.journal(Lorg/apache/hadoop/hdfs/server/protocol/NamenodeRegistration;JI[B)V	
org.apache.hadoop.hdfs.server.namenode.BackupNode$BackupNodeRpcServer.startLogSegment(Lorg/apache/hadoop/hdfs/server/protocol/NamenodeRegistration;J)V	org.apache.hadoop.hdfs.server.protocol.JournalProtocol.startLogSegment(Lorg/apache/hadoop/hdfs/server/protocol/NamenodeRegistration;J)V	
org.apache.hadoop.hdfs.server.namenode.NameNodeRpcServer.getBlocks(Lorg/apache/hadoop/hdfs/protocol/DatanodeInfo;J)Lorg/apache/hadoop/hdfs/server/protocol/BlocksWithLocations;	org.apache.hadoop.hdfs.server.protocol.NamenodeProtocol.getBlocks(Lorg/apache/hadoop/hdfs/protocol/DatanodeInfo;J)Lorg/apache/hadoop/hdfs/server/protocol/BlocksWithLocations;	
org.apache.hadoop.hdfs.server.namenode.NameNodeRpcServer.getBlockKeys()Lorg/apache/hadoop/hdfs/security/token/block/ExportedBlockKeys;	org.apache.hadoop.hdfs.server.protocol.NamenodeProtocol.getBlockKeys()Lorg/apache/hadoop/hdfs/security/token/block/ExportedBlockKeys;	
org.apache.hadoop.hdfs.server.namenode.NameNodeRpcServer.errorReport(Lorg/apache/hadoop/hdfs/server/protocol/NamenodeRegistration;ILjava/lang/String;)V	org.apache.hadoop.hdfs.server.protocol.NamenodeProtocol.errorReport(Lorg/apache/hadoop/hdfs/server/protocol/NamenodeRegistration;ILjava/lang/String;)V	
org.apache.hadoop.hdfs.server.namenode.NameNodeRpcServer.register(Lorg/apache/hadoop/hdfs/server/protocol/NamenodeRegistration;)Lorg/apache/hadoop/hdfs/server/protocol/NamenodeRegistration;	org.apache.hadoop.hdfs.server.protocol.NamenodeProtocol.register(Lorg/apache/hadoop/hdfs/server/protocol/NamenodeRegistration;)Lorg/apache/hadoop/hdfs/server/protocol/NamenodeRegistration;	
org.apache.hadoop.hdfs.server.namenode.NameNodeRpcServer.startCheckpoint(Lorg/apache/hadoop/hdfs/server/protocol/NamenodeRegistration;)Lorg/apache/hadoop/hdfs/server/protocol/NamenodeCommand;	org.apache.hadoop.hdfs.server.protocol.NamenodeProtocol.startCheckpoint(Lorg/apache/hadoop/hdfs/server/protocol/NamenodeRegistration;)Lorg/apache/hadoop/hdfs/server/protocol/NamenodeCommand;	
org.apache.hadoop.hdfs.server.namenode.NameNodeRpcServer.endCheckpoint(Lorg/apache/hadoop/hdfs/server/protocol/NamenodeRegistration;Lorg/apache/hadoop/hdfs/server/namenode/CheckpointSignature;)V	org.apache.hadoop.hdfs.server.protocol.NamenodeProtocol.endCheckpoint(Lorg/apache/hadoop/hdfs/server/protocol/NamenodeRegistration;Lorg/apache/hadoop/hdfs/server/namenode/CheckpointSignature;)V	
org.apache.hadoop.hdfs.server.namenode.NameNodeRpcServer.getDelegationToken(Lorg/apache/hadoop/io/Text;)Lorg/apache/hadoop/security/token/Token;	org.apache.hadoop.hdfs.protocol.ClientProtocol.getDelegationToken(Lorg/apache/hadoop/io/Text;)Lorg/apache/hadoop/security/token/Token;	
org.apache.hadoop.hdfs.server.namenode.NameNodeRpcServer.renewDelegationToken(Lorg/apache/hadoop/security/token/Token;)J	org.apache.hadoop.hdfs.protocol.ClientProtocol.renewDelegationToken(Lorg/apache/hadoop/security/token/Token;)J	
org.apache.hadoop.hdfs.server.namenode.NameNodeRpcServer.cancelDelegationToken(Lorg/apache/hadoop/security/token/Token;)V	org.apache.hadoop.hdfs.protocol.ClientProtocol.cancelDelegationToken(Lorg/apache/hadoop/security/token/Token;)V	
org.apache.hadoop.hdfs.server.namenode.NameNodeRpcServer.getBlockLocations(Ljava/lang/String;JJ)Lorg/apache/hadoop/hdfs/protocol/LocatedBlocks;	org.apache.hadoop.hdfs.protocol.ClientProtocol.getBlockLocations(Ljava/lang/String;JJ)Lorg/apache/hadoop/hdfs/protocol/LocatedBlocks;	
org.apache.hadoop.hdfs.server.namenode.NameNodeRpcServer.getServerDefaults()Lorg/apache/hadoop/fs/FsServerDefaults;	org.apache.hadoop.hdfs.protocol.ClientProtocol.getServerDefaults()Lorg/apache/hadoop/fs/FsServerDefaults;	
org.apache.hadoop.hdfs.server.namenode.NameNodeRpcServer.create(Ljava/lang/String;Lorg/apache/hadoop/fs/permission/FsPermission;Ljava/lang/String;Lorg/apache/hadoop/io/EnumSetWritable;ZSJ)V	org.apache.hadoop.hdfs.protocol.ClientProtocol.create(Ljava/lang/String;Lorg/apache/hadoop/fs/permission/FsPermission;Ljava/lang/String;Lorg/apache/hadoop/io/EnumSetWritable;ZSJ)V	
org.apache.hadoop.hdfs.server.namenode.NameNodeRpcServer.append(Ljava/lang/String;Ljava/lang/String;)Lorg/apache/hadoop/hdfs/protocol/LocatedBlock;	org.apache.hadoop.hdfs.protocol.ClientProtocol.append(Ljava/lang/String;Ljava/lang/String;)Lorg/apache/hadoop/hdfs/protocol/LocatedBlock;	
org.apache.hadoop.hdfs.server.namenode.NameNodeRpcServer.recoverLease(Ljava/lang/String;Ljava/lang/String;)Z	org.apache.hadoop.hdfs.protocol.ClientProtocol.recoverLease(Ljava/lang/String;Ljava/lang/String;)Z	
org.apache.hadoop.hdfs.server.namenode.NameNodeRpcServer.setReplication(Ljava/lang/String;S)Z	org.apache.hadoop.hdfs.protocol.ClientProtocol.setReplication(Ljava/lang/String;S)Z	
org.apache.hadoop.hdfs.server.namenode.NameNodeRpcServer.setPermission(Ljava/lang/String;Lorg/apache/hadoop/fs/permission/FsPermission;)V	org.apache.hadoop.hdfs.protocol.ClientProtocol.setPermission(Ljava/lang/String;Lorg/apache/hadoop/fs/permission/FsPermission;)V	
org.apache.hadoop.hdfs.server.namenode.NameNodeRpcServer.setOwner(Ljava/lang/String;Ljava/lang/String;Ljava/lang/String;)V	org.apache.hadoop.hdfs.protocol.ClientProtocol.setOwner(Ljava/lang/String;Ljava/lang/String;Ljava/lang/String;)V	
org.apache.hadoop.hdfs.server.namenode.NameNodeRpcServer.addBlock(Ljava/lang/String;Ljava/lang/String;Lorg/apache/hadoop/hdfs/protocol/ExtendedBlock;[Lorg/apache/hadoop/hdfs/protocol/DatanodeInfo;)Lorg/apache/hadoop/hdfs/protocol/LocatedBlock;	org.apache.hadoop.hdfs.protocol.ClientProtocol.addBlock(Ljava/lang/String;Ljava/lang/String;Lorg/apache/hadoop/hdfs/protocol/ExtendedBlock;[Lorg/apache/hadoop/hdfs/protocol/DatanodeInfo;)Lorg/apache/hadoop/hdfs/protocol/LocatedBlock;	
org.apache.hadoop.hdfs.server.namenode.NameNodeRpcServer.getAdditionalDatanode(Ljava/lang/String;Lorg/apache/hadoop/hdfs/protocol/ExtendedBlock;[Lorg/apache/hadoop/hdfs/protocol/DatanodeInfo;[Lorg/apache/hadoop/hdfs/protocol/DatanodeInfo;ILjava/lang/String;)Lorg/apache/hadoop/hdfs/protocol/LocatedBlock;	org.apache.hadoop.hdfs.protocol.ClientProtocol.getAdditionalDatanode(Ljava/lang/String;Lorg/apache/hadoop/hdfs/protocol/ExtendedBlock;[Lorg/apache/hadoop/hdfs/protocol/DatanodeInfo;[Lorg/apache/hadoop/hdfs/protocol/DatanodeInfo;ILjava/lang/String;)Lorg/apache/hadoop/hdfs/protocol/LocatedBlock;	
org.apache.hadoop.hdfs.server.namenode.NameNodeRpcServer.abandonBlock(Lorg/apache/hadoop/hdfs/protocol/ExtendedBlock;Ljava/lang/String;Ljava/lang/String;)V	org.apache.hadoop.hdfs.protocol.ClientProtocol.abandonBlock(Lorg/apache/hadoop/hdfs/protocol/ExtendedBlock;Ljava/lang/String;Ljava/lang/String;)V	
org.apache.hadoop.hdfs.server.namenode.NameNodeRpcServer.complete(Ljava/lang/String;Ljava/lang/String;Lorg/apache/hadoop/hdfs/protocol/ExtendedBlock;)Z	org.apache.hadoop.hdfs.protocol.ClientProtocol.complete(Ljava/lang/String;Ljava/lang/String;Lorg/apache/hadoop/hdfs/protocol/ExtendedBlock;)Z	
org.apache.hadoop.hdfs.server.namenode.NameNodeRpcServer.reportBadBlocks([Lorg/apache/hadoop/hdfs/protocol/LocatedBlock;)V	org.apache.hadoop.hdfs.protocol.ClientProtocol.reportBadBlocks([Lorg/apache/hadoop/hdfs/protocol/LocatedBlock;)V	org.apache.hadoop.hdfs.server.protocol.DatanodeProtocol.reportBadBlocks([Lorg/apache/hadoop/hdfs/protocol/LocatedBlock;)V	
org.apache.hadoop.hdfs.server.namenode.NameNodeRpcServer.updateBlockForPipeline(Lorg/apache/hadoop/hdfs/protocol/ExtendedBlock;Ljava/lang/String;)Lorg/apache/hadoop/hdfs/protocol/LocatedBlock;	org.apache.hadoop.hdfs.protocol.ClientProtocol.updateBlockForPipeline(Lorg/apache/hadoop/hdfs/protocol/ExtendedBlock;Ljava/lang/String;)Lorg/apache/hadoop/hdfs/protocol/LocatedBlock;	
org.apache.hadoop.hdfs.server.namenode.NameNodeRpcServer.updatePipeline(Ljava/lang/String;Lorg/apache/hadoop/hdfs/protocol/ExtendedBlock;Lorg/apache/hadoop/hdfs/protocol/ExtendedBlock;[Lorg/apache/hadoop/hdfs/protocol/DatanodeID;)V	org.apache.hadoop.hdfs.protocol.ClientProtocol.updatePipeline(Ljava/lang/String;Lorg/apache/hadoop/hdfs/protocol/ExtendedBlock;Lorg/apache/hadoop/hdfs/protocol/ExtendedBlock;[Lorg/apache/hadoop/hdfs/protocol/DatanodeID;)V	
org.apache.hadoop.hdfs.server.namenode.NameNodeRpcServer.commitBlockSynchronization(Lorg/apache/hadoop/hdfs/protocol/ExtendedBlock;JJZZ[Lorg/apache/hadoop/hdfs/protocol/DatanodeID;)V	org.apache.hadoop.hdfs.server.protocol.DatanodeProtocol.commitBlockSynchronization(Lorg/apache/hadoop/hdfs/protocol/ExtendedBlock;JJZZ[Lorg/apache/hadoop/hdfs/protocol/DatanodeID;)V	
org.apache.hadoop.hdfs.server.namenode.NameNodeRpcServer.getPreferredBlockSize(Ljava/lang/String;)J	org.apache.hadoop.hdfs.protocol.ClientProtocol.getPreferredBlockSize(Ljava/lang/String;)J	
org.apache.hadoop.hdfs.server.namenode.NameNodeRpcServer.rename(Ljava/lang/String;Ljava/lang/String;)Z	org.apache.hadoop.hdfs.protocol.ClientProtocol.rename(Ljava/lang/String;Ljava/lang/String;)Z	
org.apache.hadoop.hdfs.server.namenode.NameNodeRpcServer.concat(Ljava/lang/String;[Ljava/lang/String;)V	org.apache.hadoop.hdfs.protocol.ClientProtocol.concat(Ljava/lang/String;[Ljava/lang/String;)V	
org.apache.hadoop.hdfs.server.namenode.NameNodeRpcServer.rename2(Ljava/lang/String;Ljava/lang/String;[Lorg/apache/hadoop/fs/Options$Rename;)V	org.apache.hadoop.hdfs.protocol.ClientProtocol.rename2(Ljava/lang/String;Ljava/lang/String;[Lorg/apache/hadoop/fs/Options$Rename;)V	
org.apache.hadoop.hdfs.server.namenode.NameNodeRpcServer.delete(Ljava/lang/String;Z)Z	org.apache.hadoop.hdfs.protocol.ClientProtocol.delete(Ljava/lang/String;Z)Z	
org.apache.hadoop.hdfs.server.namenode.NameNodeRpcServer.mkdirs(Ljava/lang/String;Lorg/apache/hadoop/fs/permission/FsPermission;Z)Z	org.apache.hadoop.hdfs.protocol.ClientProtocol.mkdirs(Ljava/lang/String;Lorg/apache/hadoop/fs/permission/FsPermission;Z)Z	
org.apache.hadoop.hdfs.server.namenode.NameNodeRpcServer.renewLease(Ljava/lang/String;)V	org.apache.hadoop.hdfs.protocol.ClientProtocol.renewLease(Ljava/lang/String;)V	
org.apache.hadoop.hdfs.server.namenode.NameNodeRpcServer.getListing(Ljava/lang/String;[BZ)Lorg/apache/hadoop/hdfs/protocol/DirectoryListing;	org.apache.hadoop.hdfs.protocol.ClientProtocol.getListing(Ljava/lang/String;[BZ)Lorg/apache/hadoop/hdfs/protocol/DirectoryListing;	
org.apache.hadoop.hdfs.server.namenode.NameNodeRpcServer.getFileInfo(Ljava/lang/String;)Lorg/apache/hadoop/hdfs/protocol/HdfsFileStatus;	org.apache.hadoop.hdfs.protocol.ClientProtocol.getFileInfo(Ljava/lang/String;)Lorg/apache/hadoop/hdfs/protocol/HdfsFileStatus;	
org.apache.hadoop.hdfs.server.namenode.NameNodeRpcServer.getFileLinkInfo(Ljava/lang/String;)Lorg/apache/hadoop/hdfs/protocol/HdfsFileStatus;	org.apache.hadoop.hdfs.protocol.ClientProtocol.getFileLinkInfo(Ljava/lang/String;)Lorg/apache/hadoop/hdfs/protocol/HdfsFileStatus;	
org.apache.hadoop.hdfs.server.namenode.NameNodeRpcServer.getStats()[J	org.apache.hadoop.hdfs.protocol.ClientProtocol.getStats()[J	
org.apache.hadoop.hdfs.server.namenode.NameNodeRpcServer.getDatanodeReport(Lorg/apache/hadoop/hdfs/protocol/HdfsConstants$DatanodeReportType;)[Lorg/apache/hadoop/hdfs/protocol/DatanodeInfo;	org.apache.hadoop.hdfs.protocol.ClientProtocol.getDatanodeReport(Lorg/apache/hadoop/hdfs/protocol/HdfsConstants$DatanodeReportType;)[Lorg/apache/hadoop/hdfs/protocol/DatanodeInfo;	
org.apache.hadoop.hdfs.server.namenode.NameNodeRpcServer.setSafeMode(Lorg/apache/hadoop/hdfs/protocol/HdfsConstants$SafeModeAction;)Z	org.apache.hadoop.hdfs.protocol.ClientProtocol.setSafeMode(Lorg/apache/hadoop/hdfs/protocol/HdfsConstants$SafeModeAction;)Z	
org.apache.hadoop.hdfs.server.namenode.NameNodeRpcServer.restoreFailedStorage(Ljava/lang/String;)Z	org.apache.hadoop.hdfs.protocol.ClientProtocol.restoreFailedStorage(Ljava/lang/String;)Z	
org.apache.hadoop.hdfs.server.namenode.NameNodeRpcServer.saveNamespace()V	org.apache.hadoop.hdfs.protocol.ClientProtocol.saveNamespace()V	
org.apache.hadoop.hdfs.server.namenode.NameNodeRpcServer.refreshNodes()V	org.apache.hadoop.hdfs.protocol.ClientProtocol.refreshNodes()V	
org.apache.hadoop.hdfs.server.namenode.NameNodeRpcServer.getTransactionID()J	org.apache.hadoop.hdfs.server.protocol.NamenodeProtocol.getTransactionID()J	
org.apache.hadoop.hdfs.server.namenode.NameNodeRpcServer.rollEditLog()Lorg/apache/hadoop/hdfs/server/namenode/CheckpointSignature;	org.apache.hadoop.hdfs.server.protocol.NamenodeProtocol.rollEditLog()Lorg/apache/hadoop/hdfs/server/namenode/CheckpointSignature;	
org.apache.hadoop.hdfs.server.namenode.NameNodeRpcServer.getEditLogManifest(J)Lorg/apache/hadoop/hdfs/server/protocol/RemoteEditLogManifest;	org.apache.hadoop.hdfs.server.protocol.NamenodeProtocol.getEditLogManifest(J)Lorg/apache/hadoop/hdfs/server/protocol/RemoteEditLogManifest;	
org.apache.hadoop.hdfs.server.namenode.NameNodeRpcServer.finalizeUpgrade()V	org.apache.hadoop.hdfs.protocol.ClientProtocol.finalizeUpgrade()V	
org.apache.hadoop.hdfs.server.namenode.NameNodeRpcServer.distributedUpgradeProgress(Lorg/apache/hadoop/hdfs/protocol/HdfsConstants$UpgradeAction;)Lorg/apache/hadoop/hdfs/server/common/UpgradeStatusReport;	org.apache.hadoop.hdfs.protocol.ClientProtocol.distributedUpgradeProgress(Lorg/apache/hadoop/hdfs/protocol/HdfsConstants$UpgradeAction;)Lorg/apache/hadoop/hdfs/server/common/UpgradeStatusReport;	
org.apache.hadoop.hdfs.server.namenode.NameNodeRpcServer.metaSave(Ljava/lang/String;)V	org.apache.hadoop.hdfs.protocol.ClientProtocol.metaSave(Ljava/lang/String;)V	
org.apache.hadoop.hdfs.server.namenode.NameNodeRpcServer.listCorruptFileBlocks(Ljava/lang/String;Ljava/lang/String;)Lorg/apache/hadoop/hdfs/protocol/CorruptFileBlocks;	org.apache.hadoop.hdfs.protocol.ClientProtocol.listCorruptFileBlocks(Ljava/lang/String;Ljava/lang/String;)Lorg/apache/hadoop/hdfs/protocol/CorruptFileBlocks;	
org.apache.hadoop.hdfs.server.namenode.NameNodeRpcServer.setBalancerBandwidth(J)V	org.apache.hadoop.hdfs.protocol.ClientProtocol.setBalancerBandwidth(J)V	
org.apache.hadoop.hdfs.server.namenode.NameNodeRpcServer.getContentSummary(Ljava/lang/String;)Lorg/apache/hadoop/fs/ContentSummary;	org.apache.hadoop.hdfs.protocol.ClientProtocol.getContentSummary(Ljava/lang/String;)Lorg/apache/hadoop/fs/ContentSummary;	
org.apache.hadoop.hdfs.server.namenode.NameNodeRpcServer.setQuota(Ljava/lang/String;JJ)V	org.apache.hadoop.hdfs.protocol.ClientProtocol.setQuota(Ljava/lang/String;JJ)V	
org.apache.hadoop.hdfs.server.namenode.NameNodeRpcServer.fsync(Ljava/lang/String;Ljava/lang/String;)V	org.apache.hadoop.hdfs.protocol.ClientProtocol.fsync(Ljava/lang/String;Ljava/lang/String;)V	
org.apache.hadoop.hdfs.server.namenode.NameNodeRpcServer.setTimes(Ljava/lang/String;JJ)V	org.apache.hadoop.hdfs.protocol.ClientProtocol.setTimes(Ljava/lang/String;JJ)V	
org.apache.hadoop.hdfs.server.namenode.NameNodeRpcServer.createSymlink(Ljava/lang/String;Ljava/lang/String;Lorg/apache/hadoop/fs/permission/FsPermission;Z)V	org.apache.hadoop.hdfs.protocol.ClientProtocol.createSymlink(Ljava/lang/String;Ljava/lang/String;Lorg/apache/hadoop/fs/permission/FsPermission;Z)V	
org.apache.hadoop.hdfs.server.namenode.NameNodeRpcServer.getLinkTarget(Ljava/lang/String;)Ljava/lang/String;	org.apache.hadoop.hdfs.protocol.ClientProtocol.getLinkTarget(Ljava/lang/String;)Ljava/lang/String;	
org.apache.hadoop.hdfs.server.namenode.NameNodeRpcServer.registerDatanode(Lorg/apache/hadoop/hdfs/server/protocol/DatanodeRegistration;)Lorg/apache/hadoop/hdfs/server/protocol/DatanodeRegistration;	org.apache.hadoop.hdfs.server.protocol.DatanodeProtocol.registerDatanode(Lorg/apache/hadoop/hdfs/server/protocol/DatanodeRegistration;)Lorg/apache/hadoop/hdfs/server/protocol/DatanodeRegistration;	
org.apache.hadoop.hdfs.server.namenode.NameNodeRpcServer.sendHeartbeat(Lorg/apache/hadoop/hdfs/server/protocol/DatanodeRegistration;JJJJIII)[Lorg/apache/hadoop/hdfs/server/protocol/DatanodeCommand;	org.apache.hadoop.hdfs.server.protocol.DatanodeProtocol.sendHeartbeat(Lorg/apache/hadoop/hdfs/server/protocol/DatanodeRegistration;JJJJIII)[Lorg/apache/hadoop/hdfs/server/protocol/DatanodeCommand;	
org.apache.hadoop.hdfs.server.namenode.NameNodeRpcServer.blockReport(Lorg/apache/hadoop/hdfs/server/protocol/DatanodeRegistration;Ljava/lang/String;[J)Lorg/apache/hadoop/hdfs/server/protocol/DatanodeCommand;	org.apache.hadoop.hdfs.server.protocol.DatanodeProtocol.blockReport(Lorg/apache/hadoop/hdfs/server/protocol/DatanodeRegistration;Ljava/lang/String;[J)Lorg/apache/hadoop/hdfs/server/protocol/DatanodeCommand;	
org.apache.hadoop.hdfs.server.namenode.NameNodeRpcServer.blockReceived(Lorg/apache/hadoop/hdfs/server/protocol/DatanodeRegistration;Ljava/lang/String;[Lorg/apache/hadoop/hdfs/protocol/Block;[Ljava/lang/String;)V	org.apache.hadoop.hdfs.server.protocol.DatanodeProtocol.blockReceived(Lorg/apache/hadoop/hdfs/server/protocol/DatanodeRegistration;Ljava/lang/String;[Lorg/apache/hadoop/hdfs/protocol/Block;[Ljava/lang/String;)V	
org.apache.hadoop.hdfs.server.namenode.NameNodeRpcServer.errorReport(Lorg/apache/hadoop/hdfs/server/protocol/DatanodeRegistration;ILjava/lang/String;)V	org.apache.hadoop.hdfs.server.protocol.DatanodeProtocol.errorReport(Lorg/apache/hadoop/hdfs/server/protocol/DatanodeRegistration;ILjava/lang/String;)V	
org.apache.hadoop.hdfs.server.namenode.NameNodeRpcServer.versionRequest()Lorg/apache/hadoop/hdfs/server/protocol/NamespaceInfo;	org.apache.hadoop.hdfs.server.protocol.DatanodeProtocol.versionRequest()Lorg/apache/hadoop/hdfs/server/protocol/NamespaceInfo;	org.apache.hadoop.hdfs.server.protocol.NamenodeProtocol.versionRequest()Lorg/apache/hadoop/hdfs/server/protocol/NamespaceInfo;	
org.apache.hadoop.hdfs.server.namenode.NameNodeRpcServer.processUpgradeCommand(Lorg/apache/hadoop/hdfs/server/protocol/UpgradeCommand;)Lorg/apache/hadoop/hdfs/server/protocol/UpgradeCommand;	org.apache.hadoop.hdfs.server.protocol.DatanodeProtocol.processUpgradeCommand(Lorg/apache/hadoop/hdfs/server/protocol/UpgradeCommand;)Lorg/apache/hadoop/hdfs/server/protocol/UpgradeCommand;	
