//format: implementation method's signature  	  interface method's signature1  ..2 .. if any
org.apache.hadoop.yarn.server.nodemanager.containermanager.ContainerManagerImpl.startContainer(Lorg/apache/hadoop/yarn/api/protocolrecords/StartContainerRequest;)Lorg/apache/hadoop/yarn/api/protocolrecords/StartContainerResponse;	org.apache.hadoop.yarn.api.ContainerManager.startContainer(Lorg/apache/hadoop/yarn/api/protocolrecords/StartContainerRequest;)Lorg/apache/hadoop/yarn/api/protocolrecords/StartContainerResponse;	
org.apache.hadoop.yarn.server.nodemanager.containermanager.ContainerManagerImpl.stopContainer(Lorg/apache/hadoop/yarn/api/protocolrecords/StopContainerRequest;)Lorg/apache/hadoop/yarn/api/protocolrecords/StopContainerResponse;	org.apache.hadoop.yarn.api.ContainerManager.stopContainer(Lorg/apache/hadoop/yarn/api/protocolrecords/StopContainerRequest;)Lorg/apache/hadoop/yarn/api/protocolrecords/StopContainerResponse;	
org.apache.hadoop.yarn.server.nodemanager.containermanager.ContainerManagerImpl.getContainerStatus(Lorg/apache/hadoop/yarn/api/protocolrecords/GetContainerStatusRequest;)Lorg/apache/hadoop/yarn/api/protocolrecords/GetContainerStatusResponse;	org.apache.hadoop.yarn.api.ContainerManager.getContainerStatus(Lorg/apache/hadoop/yarn/api/protocolrecords/GetContainerStatusRequest;)Lorg/apache/hadoop/yarn/api/protocolrecords/GetContainerStatusResponse;	
org.apache.hadoop.yarn.server.resourcemanager.AdminService.refreshQueues(Lorg/apache/hadoop/yarn/server/resourcemanager/api/protocolrecords/RefreshQueuesRequest;)Lorg/apache/hadoop/yarn/server/resourcemanager/api/protocolrecords/RefreshQueuesResponse;	org.apache.hadoop.yarn.server.resourcemanager.api.RMAdminProtocol.refreshQueues(Lorg/apache/hadoop/yarn/server/resourcemanager/api/protocolrecords/RefreshQueuesRequest;)Lorg/apache/hadoop/yarn/server/resourcemanager/api/protocolrecords/RefreshQueuesResponse;	
org.apache.hadoop.yarn.server.resourcemanager.AdminService.refreshNodes(Lorg/apache/hadoop/yarn/server/resourcemanager/api/protocolrecords/RefreshNodesRequest;)Lorg/apache/hadoop/yarn/server/resourcemanager/api/protocolrecords/RefreshNodesResponse;	org.apache.hadoop.yarn.server.resourcemanager.api.RMAdminProtocol.refreshNodes(Lorg/apache/hadoop/yarn/server/resourcemanager/api/protocolrecords/RefreshNodesRequest;)Lorg/apache/hadoop/yarn/server/resourcemanager/api/protocolrecords/RefreshNodesResponse;	
org.apache.hadoop.yarn.server.resourcemanager.AdminService.refreshSuperUserGroupsConfiguration(Lorg/apache/hadoop/yarn/server/resourcemanager/api/protocolrecords/RefreshSuperUserGroupsConfigurationRequest;)Lorg/apache/hadoop/yarn/server/resourcemanager/api/protocolrecords/RefreshSuperUserGroupsConfigurationResponse;	org.apache.hadoop.yarn.server.resourcemanager.api.RMAdminProtocol.refreshSuperUserGroupsConfiguration(Lorg/apache/hadoop/yarn/server/resourcemanager/api/protocolrecords/RefreshSuperUserGroupsConfigurationRequest;)Lorg/apache/hadoop/yarn/server/resourcemanager/api/protocolrecords/RefreshSuperUserGroupsConfigurationResponse;	
org.apache.hadoop.yarn.server.resourcemanager.AdminService.refreshUserToGroupsMappings(Lorg/apache/hadoop/yarn/server/resourcemanager/api/protocolrecords/RefreshUserToGroupsMappingsRequest;)Lorg/apache/hadoop/yarn/server/resourcemanager/api/protocolrecords/RefreshUserToGroupsMappingsResponse;	org.apache.hadoop.yarn.server.resourcemanager.api.RMAdminProtocol.refreshUserToGroupsMappings(Lorg/apache/hadoop/yarn/server/resourcemanager/api/protocolrecords/RefreshUserToGroupsMappingsRequest;)Lorg/apache/hadoop/yarn/server/resourcemanager/api/protocolrecords/RefreshUserToGroupsMappingsResponse;	
org.apache.hadoop.yarn.server.resourcemanager.AdminService.refreshAdminAcls(Lorg/apache/hadoop/yarn/server/resourcemanager/api/protocolrecords/RefreshAdminAclsRequest;)Lorg/apache/hadoop/yarn/server/resourcemanager/api/protocolrecords/RefreshAdminAclsResponse;	org.apache.hadoop.yarn.server.resourcemanager.api.RMAdminProtocol.refreshAdminAcls(Lorg/apache/hadoop/yarn/server/resourcemanager/api/protocolrecords/RefreshAdminAclsRequest;)Lorg/apache/hadoop/yarn/server/resourcemanager/api/protocolrecords/RefreshAdminAclsResponse;	
org.apache.hadoop.yarn.server.resourcemanager.AdminService.refreshServiceAcls(Lorg/apache/hadoop/yarn/server/resourcemanager/api/protocolrecords/RefreshServiceAclsRequest;)Lorg/apache/hadoop/yarn/server/resourcemanager/api/protocolrecords/RefreshServiceAclsResponse;	org.apache.hadoop.yarn.server.resourcemanager.api.RMAdminProtocol.refreshServiceAcls(Lorg/apache/hadoop/yarn/server/resourcemanager/api/protocolrecords/RefreshServiceAclsRequest;)Lorg/apache/hadoop/yarn/server/resourcemanager/api/protocolrecords/RefreshServiceAclsResponse;	
org.apache.hadoop.mapred.NotRunningJob.failTaskAttempt(Lorg/apache/hadoop/mapreduce/v2/api/protocolrecords/FailTaskAttemptRequest;)Lorg/apache/hadoop/mapreduce/v2/api/protocolrecords/FailTaskAttemptResponse;	org.apache.hadoop.mapreduce.v2.api.MRClientProtocol.failTaskAttempt(Lorg/apache/hadoop/mapreduce/v2/api/protocolrecords/FailTaskAttemptRequest;)Lorg/apache/hadoop/mapreduce/v2/api/protocolrecords/FailTaskAttemptResponse;	
org.apache.hadoop.mapred.NotRunningJob.getCounters(Lorg/apache/hadoop/mapreduce/v2/api/protocolrecords/GetCountersRequest;)Lorg/apache/hadoop/mapreduce/v2/api/protocolrecords/GetCountersResponse;	org.apache.hadoop.mapreduce.v2.api.MRClientProtocol.getCounters(Lorg/apache/hadoop/mapreduce/v2/api/protocolrecords/GetCountersRequest;)Lorg/apache/hadoop/mapreduce/v2/api/protocolrecords/GetCountersResponse;	
org.apache.hadoop.mapred.NotRunningJob.getDiagnostics(Lorg/apache/hadoop/mapreduce/v2/api/protocolrecords/GetDiagnosticsRequest;)Lorg/apache/hadoop/mapreduce/v2/api/protocolrecords/GetDiagnosticsResponse;	org.apache.hadoop.mapreduce.v2.api.MRClientProtocol.getDiagnostics(Lorg/apache/hadoop/mapreduce/v2/api/protocolrecords/GetDiagnosticsRequest;)Lorg/apache/hadoop/mapreduce/v2/api/protocolrecords/GetDiagnosticsResponse;	
org.apache.hadoop.mapred.NotRunningJob.getJobReport(Lorg/apache/hadoop/mapreduce/v2/api/protocolrecords/GetJobReportRequest;)Lorg/apache/hadoop/mapreduce/v2/api/protocolrecords/GetJobReportResponse;	org.apache.hadoop.mapreduce.v2.api.MRClientProtocol.getJobReport(Lorg/apache/hadoop/mapreduce/v2/api/protocolrecords/GetJobReportRequest;)Lorg/apache/hadoop/mapreduce/v2/api/protocolrecords/GetJobReportResponse;	
org.apache.hadoop.mapred.NotRunningJob.getTaskAttemptCompletionEvents(Lorg/apache/hadoop/mapreduce/v2/api/protocolrecords/GetTaskAttemptCompletionEventsRequest;)Lorg/apache/hadoop/mapreduce/v2/api/protocolrecords/GetTaskAttemptCompletionEventsResponse;	org.apache.hadoop.mapreduce.v2.api.MRClientProtocol.getTaskAttemptCompletionEvents(Lorg/apache/hadoop/mapreduce/v2/api/protocolrecords/GetTaskAttemptCompletionEventsRequest;)Lorg/apache/hadoop/mapreduce/v2/api/protocolrecords/GetTaskAttemptCompletionEventsResponse;	
org.apache.hadoop.mapred.NotRunningJob.getTaskAttemptReport(Lorg/apache/hadoop/mapreduce/v2/api/protocolrecords/GetTaskAttemptReportRequest;)Lorg/apache/hadoop/mapreduce/v2/api/protocolrecords/GetTaskAttemptReportResponse;	org.apache.hadoop.mapreduce.v2.api.MRClientProtocol.getTaskAttemptReport(Lorg/apache/hadoop/mapreduce/v2/api/protocolrecords/GetTaskAttemptReportRequest;)Lorg/apache/hadoop/mapreduce/v2/api/protocolrecords/GetTaskAttemptReportResponse;	
org.apache.hadoop.mapred.NotRunningJob.getTaskReport(Lorg/apache/hadoop/mapreduce/v2/api/protocolrecords/GetTaskReportRequest;)Lorg/apache/hadoop/mapreduce/v2/api/protocolrecords/GetTaskReportResponse;	org.apache.hadoop.mapreduce.v2.api.MRClientProtocol.getTaskReport(Lorg/apache/hadoop/mapreduce/v2/api/protocolrecords/GetTaskReportRequest;)Lorg/apache/hadoop/mapreduce/v2/api/protocolrecords/GetTaskReportResponse;	
org.apache.hadoop.mapred.NotRunningJob.getTaskReports(Lorg/apache/hadoop/mapreduce/v2/api/protocolrecords/GetTaskReportsRequest;)Lorg/apache/hadoop/mapreduce/v2/api/protocolrecords/GetTaskReportsResponse;	org.apache.hadoop.mapreduce.v2.api.MRClientProtocol.getTaskReports(Lorg/apache/hadoop/mapreduce/v2/api/protocolrecords/GetTaskReportsRequest;)Lorg/apache/hadoop/mapreduce/v2/api/protocolrecords/GetTaskReportsResponse;	
org.apache.hadoop.mapred.NotRunningJob.killJob(Lorg/apache/hadoop/mapreduce/v2/api/protocolrecords/KillJobRequest;)Lorg/apache/hadoop/mapreduce/v2/api/protocolrecords/KillJobResponse;	org.apache.hadoop.mapreduce.v2.api.MRClientProtocol.killJob(Lorg/apache/hadoop/mapreduce/v2/api/protocolrecords/KillJobRequest;)Lorg/apache/hadoop/mapreduce/v2/api/protocolrecords/KillJobResponse;	
org.apache.hadoop.mapred.NotRunningJob.killTask(Lorg/apache/hadoop/mapreduce/v2/api/protocolrecords/KillTaskRequest;)Lorg/apache/hadoop/mapreduce/v2/api/protocolrecords/KillTaskResponse;	org.apache.hadoop.mapreduce.v2.api.MRClientProtocol.killTask(Lorg/apache/hadoop/mapreduce/v2/api/protocolrecords/KillTaskRequest;)Lorg/apache/hadoop/mapreduce/v2/api/protocolrecords/KillTaskResponse;	
org.apache.hadoop.mapred.NotRunningJob.killTaskAttempt(Lorg/apache/hadoop/mapreduce/v2/api/protocolrecords/KillTaskAttemptRequest;)Lorg/apache/hadoop/mapreduce/v2/api/protocolrecords/KillTaskAttemptResponse;	org.apache.hadoop.mapreduce.v2.api.MRClientProtocol.killTaskAttempt(Lorg/apache/hadoop/mapreduce/v2/api/protocolrecords/KillTaskAttemptRequest;)Lorg/apache/hadoop/mapreduce/v2/api/protocolrecords/KillTaskAttemptResponse;	
org.apache.hadoop.mapred.NotRunningJob.getDelegationToken(Lorg/apache/hadoop/mapreduce/v2/api/protocolrecords/GetDelegationTokenRequest;)Lorg/apache/hadoop/mapreduce/v2/api/protocolrecords/GetDelegationTokenResponse;	org.apache.hadoop.mapreduce.v2.api.MRClientProtocol.getDelegationToken(Lorg/apache/hadoop/mapreduce/v2/api/protocolrecords/GetDelegationTokenRequest;)Lorg/apache/hadoop/mapreduce/v2/api/protocolrecords/GetDelegationTokenResponse;	
org.apache.hadoop.yarn.server.resourcemanager.ApplicationMasterService.registerApplicationMaster(Lorg/apache/hadoop/yarn/api/protocolrecords/RegisterApplicationMasterRequest;)Lorg/apache/hadoop/yarn/api/protocolrecords/RegisterApplicationMasterResponse;	org.apache.hadoop.yarn.api.AMRMProtocol.registerApplicationMaster(Lorg/apache/hadoop/yarn/api/protocolrecords/RegisterApplicationMasterRequest;)Lorg/apache/hadoop/yarn/api/protocolrecords/RegisterApplicationMasterResponse;	
org.apache.hadoop.yarn.server.resourcemanager.ApplicationMasterService.finishApplicationMaster(Lorg/apache/hadoop/yarn/api/protocolrecords/FinishApplicationMasterRequest;)Lorg/apache/hadoop/yarn/api/protocolrecords/FinishApplicationMasterResponse;	org.apache.hadoop.yarn.api.AMRMProtocol.finishApplicationMaster(Lorg/apache/hadoop/yarn/api/protocolrecords/FinishApplicationMasterRequest;)Lorg/apache/hadoop/yarn/api/protocolrecords/FinishApplicationMasterResponse;	
org.apache.hadoop.yarn.server.resourcemanager.ApplicationMasterService.allocate(Lorg/apache/hadoop/yarn/api/protocolrecords/AllocateRequest;)Lorg/apache/hadoop/yarn/api/protocolrecords/AllocateResponse;	org.apache.hadoop.yarn.api.AMRMProtocol.allocate(Lorg/apache/hadoop/yarn/api/protocolrecords/AllocateRequest;)Lorg/apache/hadoop/yarn/api/protocolrecords/AllocateResponse;	
org.apache.hadoop.yarn.server.resourcemanager.ClientRMService.getNewApplication(Lorg/apache/hadoop/yarn/api/protocolrecords/GetNewApplicationRequest;)Lorg/apache/hadoop/yarn/api/protocolrecords/GetNewApplicationResponse;	org.apache.hadoop.yarn.api.ClientRMProtocol.getNewApplication(Lorg/apache/hadoop/yarn/api/protocolrecords/GetNewApplicationRequest;)Lorg/apache/hadoop/yarn/api/protocolrecords/GetNewApplicationResponse;	
org.apache.hadoop.yarn.server.resourcemanager.ClientRMService.getApplicationReport(Lorg/apache/hadoop/yarn/api/protocolrecords/GetApplicationReportRequest;)Lorg/apache/hadoop/yarn/api/protocolrecords/GetApplicationReportResponse;	org.apache.hadoop.yarn.api.ClientRMProtocol.getApplicationReport(Lorg/apache/hadoop/yarn/api/protocolrecords/GetApplicationReportRequest;)Lorg/apache/hadoop/yarn/api/protocolrecords/GetApplicationReportResponse;	
org.apache.hadoop.yarn.server.resourcemanager.ClientRMService.submitApplication(Lorg/apache/hadoop/yarn/api/protocolrecords/SubmitApplicationRequest;)Lorg/apache/hadoop/yarn/api/protocolrecords/SubmitApplicationResponse;	org.apache.hadoop.yarn.api.ClientRMProtocol.submitApplication(Lorg/apache/hadoop/yarn/api/protocolrecords/SubmitApplicationRequest;)Lorg/apache/hadoop/yarn/api/protocolrecords/SubmitApplicationResponse;	
org.apache.hadoop.yarn.server.resourcemanager.ClientRMService.forceKillApplication(Lorg/apache/hadoop/yarn/api/protocolrecords/KillApplicationRequest;)Lorg/apache/hadoop/yarn/api/protocolrecords/KillApplicationResponse;	org.apache.hadoop.yarn.api.ClientRMProtocol.forceKillApplication(Lorg/apache/hadoop/yarn/api/protocolrecords/KillApplicationRequest;)Lorg/apache/hadoop/yarn/api/protocolrecords/KillApplicationResponse;	
org.apache.hadoop.yarn.server.resourcemanager.ClientRMService.getClusterMetrics(Lorg/apache/hadoop/yarn/api/protocolrecords/GetClusterMetricsRequest;)Lorg/apache/hadoop/yarn/api/protocolrecords/GetClusterMetricsResponse;	org.apache.hadoop.yarn.api.ClientRMProtocol.getClusterMetrics(Lorg/apache/hadoop/yarn/api/protocolrecords/GetClusterMetricsRequest;)Lorg/apache/hadoop/yarn/api/protocolrecords/GetClusterMetricsResponse;	
org.apache.hadoop.yarn.server.resourcemanager.ClientRMService.getAllApplications(Lorg/apache/hadoop/yarn/api/protocolrecords/GetAllApplicationsRequest;)Lorg/apache/hadoop/yarn/api/protocolrecords/GetAllApplicationsResponse;	org.apache.hadoop.yarn.api.ClientRMProtocol.getAllApplications(Lorg/apache/hadoop/yarn/api/protocolrecords/GetAllApplicationsRequest;)Lorg/apache/hadoop/yarn/api/protocolrecords/GetAllApplicationsResponse;	
org.apache.hadoop.yarn.server.resourcemanager.ClientRMService.getClusterNodes(Lorg/apache/hadoop/yarn/api/protocolrecords/GetClusterNodesRequest;)Lorg/apache/hadoop/yarn/api/protocolrecords/GetClusterNodesResponse;	org.apache.hadoop.yarn.api.ClientRMProtocol.getClusterNodes(Lorg/apache/hadoop/yarn/api/protocolrecords/GetClusterNodesRequest;)Lorg/apache/hadoop/yarn/api/protocolrecords/GetClusterNodesResponse;	
org.apache.hadoop.yarn.server.resourcemanager.ClientRMService.getQueueInfo(Lorg/apache/hadoop/yarn/api/protocolrecords/GetQueueInfoRequest;)Lorg/apache/hadoop/yarn/api/protocolrecords/GetQueueInfoResponse;	org.apache.hadoop.yarn.api.ClientRMProtocol.getQueueInfo(Lorg/apache/hadoop/yarn/api/protocolrecords/GetQueueInfoRequest;)Lorg/apache/hadoop/yarn/api/protocolrecords/GetQueueInfoResponse;	
org.apache.hadoop.yarn.server.resourcemanager.ClientRMService.getQueueUserAcls(Lorg/apache/hadoop/yarn/api/protocolrecords/GetQueueUserAclsInfoRequest;)Lorg/apache/hadoop/yarn/api/protocolrecords/GetQueueUserAclsInfoResponse;	org.apache.hadoop.yarn.api.ClientRMProtocol.getQueueUserAcls(Lorg/apache/hadoop/yarn/api/protocolrecords/GetQueueUserAclsInfoRequest;)Lorg/apache/hadoop/yarn/api/protocolrecords/GetQueueUserAclsInfoResponse;	
org.apache.hadoop.yarn.server.resourcemanager.ClientRMService.getDelegationToken(Lorg/apache/hadoop/yarn/api/protocolrecords/GetDelegationTokenRequest;)Lorg/apache/hadoop/yarn/api/protocolrecords/GetDelegationTokenResponse;	org.apache.hadoop.yarn.api.ClientRMProtocol.getDelegationToken(Lorg/apache/hadoop/yarn/api/protocolrecords/GetDelegationTokenRequest;)Lorg/apache/hadoop/yarn/api/protocolrecords/GetDelegationTokenResponse;	
org.apache.hadoop.yarn.server.resourcemanager.ResourceTrackerService.registerNodeManager(Lorg/apache/hadoop/yarn/server/api/protocolrecords/RegisterNodeManagerRequest;)Lorg/apache/hadoop/yarn/server/api/protocolrecords/RegisterNodeManagerResponse;	org.apache.hadoop.yarn.server.api.ResourceTracker.registerNodeManager(Lorg/apache/hadoop/yarn/server/api/protocolrecords/RegisterNodeManagerRequest;)Lorg/apache/hadoop/yarn/server/api/protocolrecords/RegisterNodeManagerResponse;	
org.apache.hadoop.yarn.server.resourcemanager.ResourceTrackerService.nodeHeartbeat(Lorg/apache/hadoop/yarn/server/api/protocolrecords/NodeHeartbeatRequest;)Lorg/apache/hadoop/yarn/server/api/protocolrecords/NodeHeartbeatResponse;	org.apache.hadoop.yarn.server.api.ResourceTracker.nodeHeartbeat(Lorg/apache/hadoop/yarn/server/api/protocolrecords/NodeHeartbeatRequest;)Lorg/apache/hadoop/yarn/server/api/protocolrecords/NodeHeartbeatResponse;	

org.apache.hadoop.mapred.LocalJobRunner.getNewJobID()Lorg/apache/hadoop/mapreduce/JobID;	org.apache.hadoop.mapreduce.protocol.ClientProtocol.getNewJobID()Lorg/apache/hadoop/mapreduce/JobID;	
org.apache.hadoop.mapred.LocalJobRunner.submitJob(Lorg/apache/hadoop/mapreduce/JobID;Ljava/lang/String;Lorg/apache/hadoop/security/Credentials;)Lorg/apache/hadoop/mapreduce/JobStatus;	org.apache.hadoop.mapreduce.protocol.ClientProtocol.submitJob(Lorg/apache/hadoop/mapreduce/JobID;Ljava/lang/String;Lorg/apache/hadoop/security/Credentials;)Lorg/apache/hadoop/mapreduce/JobStatus;	
org.apache.hadoop.mapred.LocalJobRunner.killJob(Lorg/apache/hadoop/mapreduce/JobID;)V	org.apache.hadoop.mapreduce.protocol.ClientProtocol.killJob(Lorg/apache/hadoop/mapreduce/JobID;)V	
org.apache.hadoop.mapred.LocalJobRunner.setJobPriority(Lorg/apache/hadoop/mapreduce/JobID;Ljava/lang/String;)V	org.apache.hadoop.mapreduce.protocol.ClientProtocol.setJobPriority(Lorg/apache/hadoop/mapreduce/JobID;Ljava/lang/String;)V	
org.apache.hadoop.mapred.LocalJobRunner.killTask(Lorg/apache/hadoop/mapreduce/TaskAttemptID;Z)Z	org.apache.hadoop.mapreduce.protocol.ClientProtocol.killTask(Lorg/apache/hadoop/mapreduce/TaskAttemptID;Z)Z	
org.apache.hadoop.mapred.LocalJobRunner.getTaskReports(Lorg/apache/hadoop/mapreduce/JobID;Lorg/apache/hadoop/mapreduce/TaskType;)[Lorg/apache/hadoop/mapreduce/TaskReport;	org.apache.hadoop.mapreduce.protocol.ClientProtocol.getTaskReports(Lorg/apache/hadoop/mapreduce/JobID;Lorg/apache/hadoop/mapreduce/TaskType;)[Lorg/apache/hadoop/mapreduce/TaskReport;	
org.apache.hadoop.mapred.LocalJobRunner.getJobStatus(Lorg/apache/hadoop/mapreduce/JobID;)Lorg/apache/hadoop/mapreduce/JobStatus;	org.apache.hadoop.mapreduce.protocol.ClientProtocol.getJobStatus(Lorg/apache/hadoop/mapreduce/JobID;)Lorg/apache/hadoop/mapreduce/JobStatus;	
org.apache.hadoop.mapred.LocalJobRunner.getJobCounters(Lorg/apache/hadoop/mapreduce/JobID;)Lorg/apache/hadoop/mapreduce/Counters;	org.apache.hadoop.mapreduce.protocol.ClientProtocol.getJobCounters(Lorg/apache/hadoop/mapreduce/JobID;)Lorg/apache/hadoop/mapreduce/Counters;	
org.apache.hadoop.mapred.LocalJobRunner.getFilesystemName()Ljava/lang/String;	org.apache.hadoop.mapreduce.protocol.ClientProtocol.getFilesystemName()Ljava/lang/String;	
org.apache.hadoop.mapred.LocalJobRunner.getClusterMetrics()Lorg/apache/hadoop/mapreduce/ClusterMetrics;	org.apache.hadoop.mapreduce.protocol.ClientProtocol.getClusterMetrics()Lorg/apache/hadoop/mapreduce/ClusterMetrics;	
org.apache.hadoop.mapred.LocalJobRunner.getJobTrackerStatus()Lorg/apache/hadoop/mapreduce/Cluster$JobTrackerStatus;	org.apache.hadoop.mapreduce.protocol.ClientProtocol.getJobTrackerStatus()Lorg/apache/hadoop/mapreduce/Cluster$JobTrackerStatus;	
org.apache.hadoop.mapred.LocalJobRunner.getTaskTrackerExpiryInterval()J	org.apache.hadoop.mapreduce.protocol.ClientProtocol.getTaskTrackerExpiryInterval()J	
org.apache.hadoop.mapred.LocalJobRunner.getActiveTrackers()[Lorg/apache/hadoop/mapreduce/TaskTrackerInfo;	org.apache.hadoop.mapreduce.protocol.ClientProtocol.getActiveTrackers()[Lorg/apache/hadoop/mapreduce/TaskTrackerInfo;	
org.apache.hadoop.mapred.LocalJobRunner.getBlacklistedTrackers()[Lorg/apache/hadoop/mapreduce/TaskTrackerInfo;	org.apache.hadoop.mapreduce.protocol.ClientProtocol.getBlacklistedTrackers()[Lorg/apache/hadoop/mapreduce/TaskTrackerInfo;	
org.apache.hadoop.mapred.LocalJobRunner.getTaskCompletionEvents(Lorg/apache/hadoop/mapreduce/JobID;II)[Lorg/apache/hadoop/mapreduce/TaskCompletionEvent;	org.apache.hadoop.mapreduce.protocol.ClientProtocol.getTaskCompletionEvents(Lorg/apache/hadoop/mapreduce/JobID;II)[Lorg/apache/hadoop/mapreduce/TaskCompletionEvent;	
org.apache.hadoop.mapred.LocalJobRunner.getAllJobs()[Lorg/apache/hadoop/mapreduce/JobStatus;	org.apache.hadoop.mapreduce.protocol.ClientProtocol.getAllJobs()[Lorg/apache/hadoop/mapreduce/JobStatus;	
org.apache.hadoop.mapred.LocalJobRunner.getTaskDiagnostics(Lorg/apache/hadoop/mapreduce/TaskAttemptID;)[Ljava/lang/String;	org.apache.hadoop.mapreduce.protocol.ClientProtocol.getTaskDiagnostics(Lorg/apache/hadoop/mapreduce/TaskAttemptID;)[Ljava/lang/String;	
org.apache.hadoop.mapred.LocalJobRunner.getSystemDir()Ljava/lang/String;	org.apache.hadoop.mapreduce.protocol.ClientProtocol.getSystemDir()Ljava/lang/String;	
org.apache.hadoop.mapred.LocalJobRunner.getQueueAdmins(Ljava/lang/String;)Lorg/apache/hadoop/security/authorize/AccessControlList;	org.apache.hadoop.mapreduce.protocol.ClientProtocol.getQueueAdmins(Ljava/lang/String;)Lorg/apache/hadoop/security/authorize/AccessControlList;	
org.apache.hadoop.mapred.LocalJobRunner.getStagingAreaDir()Ljava/lang/String;	org.apache.hadoop.mapreduce.protocol.ClientProtocol.getStagingAreaDir()Ljava/lang/String;	
org.apache.hadoop.mapred.LocalJobRunner.getJobHistoryDir()Ljava/lang/String;	org.apache.hadoop.mapreduce.protocol.ClientProtocol.getJobHistoryDir()Ljava/lang/String;	
org.apache.hadoop.mapred.LocalJobRunner.getChildQueues(Ljava/lang/String;)[Lorg/apache/hadoop/mapreduce/QueueInfo;	org.apache.hadoop.mapreduce.protocol.ClientProtocol.getChildQueues(Ljava/lang/String;)[Lorg/apache/hadoop/mapreduce/QueueInfo;	
org.apache.hadoop.mapred.LocalJobRunner.getRootQueues()[Lorg/apache/hadoop/mapreduce/QueueInfo;	org.apache.hadoop.mapreduce.protocol.ClientProtocol.getRootQueues()[Lorg/apache/hadoop/mapreduce/QueueInfo;	
org.apache.hadoop.mapred.LocalJobRunner.getQueues()[Lorg/apache/hadoop/mapreduce/QueueInfo;	org.apache.hadoop.mapreduce.protocol.ClientProtocol.getQueues()[Lorg/apache/hadoop/mapreduce/QueueInfo;	
org.apache.hadoop.mapred.LocalJobRunner.getQueue(Ljava/lang/String;)Lorg/apache/hadoop/mapreduce/QueueInfo;	org.apache.hadoop.mapreduce.protocol.ClientProtocol.getQueue(Ljava/lang/String;)Lorg/apache/hadoop/mapreduce/QueueInfo;	
org.apache.hadoop.mapred.LocalJobRunner.getQueueAclsForCurrentUser()[Lorg/apache/hadoop/mapreduce/QueueAclsInfo;	org.apache.hadoop.mapreduce.protocol.ClientProtocol.getQueueAclsForCurrentUser()[Lorg/apache/hadoop/mapreduce/QueueAclsInfo;	
org.apache.hadoop.mapred.LocalJobRunner.cancelDelegationToken(Lorg/apache/hadoop/security/token/Token;)V	org.apache.hadoop.mapreduce.protocol.ClientProtocol.cancelDelegationToken(Lorg/apache/hadoop/security/token/Token;)V	
org.apache.hadoop.mapred.LocalJobRunner.getDelegationToken(Lorg/apache/hadoop/io/Text;)Lorg/apache/hadoop/security/token/Token;	org.apache.hadoop.mapreduce.protocol.ClientProtocol.getDelegationToken(Lorg/apache/hadoop/io/Text;)Lorg/apache/hadoop/security/token/Token;	
org.apache.hadoop.mapred.LocalJobRunner.renewDelegationToken(Lorg/apache/hadoop/security/token/Token;)J	org.apache.hadoop.mapreduce.protocol.ClientProtocol.renewDelegationToken(Lorg/apache/hadoop/security/token/Token;)J	
org.apache.hadoop.mapred.LocalJobRunner.getLogFileParams(Lorg/apache/hadoop/mapreduce/JobID;Lorg/apache/hadoop/mapreduce/TaskAttemptID;)Lorg/apache/hadoop/mapreduce/v2/LogParams;	org.apache.hadoop.mapreduce.protocol.ClientProtocol.getLogFileParams(Lorg/apache/hadoop/mapreduce/JobID;Lorg/apache/hadoop/mapreduce/TaskAttemptID;)Lorg/apache/hadoop/mapreduce/v2/LogParams;	
org.apache.hadoop.mapred.YARNRunner.cancelDelegationToken(Lorg/apache/hadoop/security/token/Token;)V	org.apache.hadoop.mapreduce.protocol.ClientProtocol.cancelDelegationToken(Lorg/apache/hadoop/security/token/Token;)V	
org.apache.hadoop.mapred.YARNRunner.getActiveTrackers()[Lorg/apache/hadoop/mapreduce/TaskTrackerInfo;	org.apache.hadoop.mapreduce.protocol.ClientProtocol.getActiveTrackers()[Lorg/apache/hadoop/mapreduce/TaskTrackerInfo;	
org.apache.hadoop.mapred.YARNRunner.getAllJobs()[Lorg/apache/hadoop/mapreduce/JobStatus;	org.apache.hadoop.mapreduce.protocol.ClientProtocol.getAllJobs()[Lorg/apache/hadoop/mapreduce/JobStatus;	
org.apache.hadoop.mapred.YARNRunner.getBlacklistedTrackers()[Lorg/apache/hadoop/mapreduce/TaskTrackerInfo;	org.apache.hadoop.mapreduce.protocol.ClientProtocol.getBlacklistedTrackers()[Lorg/apache/hadoop/mapreduce/TaskTrackerInfo;	
org.apache.hadoop.mapred.YARNRunner.getClusterMetrics()Lorg/apache/hadoop/mapreduce/ClusterMetrics;	org.apache.hadoop.mapreduce.protocol.ClientProtocol.getClusterMetrics()Lorg/apache/hadoop/mapreduce/ClusterMetrics;	
org.apache.hadoop.mapred.YARNRunner.getDelegationToken(Lorg/apache/hadoop/io/Text;)Lorg/apache/hadoop/security/token/Token;	org.apache.hadoop.mapreduce.protocol.ClientProtocol.getDelegationToken(Lorg/apache/hadoop/io/Text;)Lorg/apache/hadoop/security/token/Token;	
org.apache.hadoop.mapred.YARNRunner.getFilesystemName()Ljava/lang/String;	org.apache.hadoop.mapreduce.protocol.ClientProtocol.getFilesystemName()Ljava/lang/String;	
org.apache.hadoop.mapred.YARNRunner.getNewJobID()Lorg/apache/hadoop/mapreduce/JobID;	org.apache.hadoop.mapreduce.protocol.ClientProtocol.getNewJobID()Lorg/apache/hadoop/mapreduce/JobID;	
org.apache.hadoop.mapred.YARNRunner.getQueue(Ljava/lang/String;)Lorg/apache/hadoop/mapreduce/QueueInfo;	org.apache.hadoop.mapreduce.protocol.ClientProtocol.getQueue(Ljava/lang/String;)Lorg/apache/hadoop/mapreduce/QueueInfo;	
org.apache.hadoop.mapred.YARNRunner.getQueueAclsForCurrentUser()[Lorg/apache/hadoop/mapreduce/QueueAclsInfo;	org.apache.hadoop.mapreduce.protocol.ClientProtocol.getQueueAclsForCurrentUser()[Lorg/apache/hadoop/mapreduce/QueueAclsInfo;	
org.apache.hadoop.mapred.YARNRunner.getQueues()[Lorg/apache/hadoop/mapreduce/QueueInfo;	org.apache.hadoop.mapreduce.protocol.ClientProtocol.getQueues()[Lorg/apache/hadoop/mapreduce/QueueInfo;	
org.apache.hadoop.mapred.YARNRunner.getRootQueues()[Lorg/apache/hadoop/mapreduce/QueueInfo;	org.apache.hadoop.mapreduce.protocol.ClientProtocol.getRootQueues()[Lorg/apache/hadoop/mapreduce/QueueInfo;	
org.apache.hadoop.mapred.YARNRunner.getChildQueues(Ljava/lang/String;)[Lorg/apache/hadoop/mapreduce/QueueInfo;	org.apache.hadoop.mapreduce.protocol.ClientProtocol.getChildQueues(Ljava/lang/String;)[Lorg/apache/hadoop/mapreduce/QueueInfo;	
org.apache.hadoop.mapred.YARNRunner.getStagingAreaDir()Ljava/lang/String;	org.apache.hadoop.mapreduce.protocol.ClientProtocol.getStagingAreaDir()Ljava/lang/String;	
org.apache.hadoop.mapred.YARNRunner.getSystemDir()Ljava/lang/String;	org.apache.hadoop.mapreduce.protocol.ClientProtocol.getSystemDir()Ljava/lang/String;	
org.apache.hadoop.mapred.YARNRunner.getTaskTrackerExpiryInterval()J	org.apache.hadoop.mapreduce.protocol.ClientProtocol.getTaskTrackerExpiryInterval()J	
org.apache.hadoop.mapred.YARNRunner.submitJob(Lorg/apache/hadoop/mapreduce/JobID;Ljava/lang/String;Lorg/apache/hadoop/security/Credentials;)Lorg/apache/hadoop/mapreduce/JobStatus;	org.apache.hadoop.mapreduce.protocol.ClientProtocol.submitJob(Lorg/apache/hadoop/mapreduce/JobID;Ljava/lang/String;Lorg/apache/hadoop/security/Credentials;)Lorg/apache/hadoop/mapreduce/JobStatus;	
org.apache.hadoop.mapred.YARNRunner.setJobPriority(Lorg/apache/hadoop/mapreduce/JobID;Ljava/lang/String;)V	org.apache.hadoop.mapreduce.protocol.ClientProtocol.setJobPriority(Lorg/apache/hadoop/mapreduce/JobID;Ljava/lang/String;)V	
org.apache.hadoop.mapred.YARNRunner.renewDelegationToken(Lorg/apache/hadoop/security/token/Token;)J	org.apache.hadoop.mapreduce.protocol.ClientProtocol.renewDelegationToken(Lorg/apache/hadoop/security/token/Token;)J	
org.apache.hadoop.mapred.YARNRunner.getJobCounters(Lorg/apache/hadoop/mapreduce/JobID;)Lorg/apache/hadoop/mapreduce/Counters;	org.apache.hadoop.mapreduce.protocol.ClientProtocol.getJobCounters(Lorg/apache/hadoop/mapreduce/JobID;)Lorg/apache/hadoop/mapreduce/Counters;	
org.apache.hadoop.mapred.YARNRunner.getJobHistoryDir()Ljava/lang/String;	org.apache.hadoop.mapreduce.protocol.ClientProtocol.getJobHistoryDir()Ljava/lang/String;	
org.apache.hadoop.mapred.YARNRunner.getJobStatus(Lorg/apache/hadoop/mapreduce/JobID;)Lorg/apache/hadoop/mapreduce/JobStatus;	org.apache.hadoop.mapreduce.protocol.ClientProtocol.getJobStatus(Lorg/apache/hadoop/mapreduce/JobID;)Lorg/apache/hadoop/mapreduce/JobStatus;	
org.apache.hadoop.mapred.YARNRunner.getTaskCompletionEvents(Lorg/apache/hadoop/mapreduce/JobID;II)[Lorg/apache/hadoop/mapreduce/TaskCompletionEvent;	org.apache.hadoop.mapreduce.protocol.ClientProtocol.getTaskCompletionEvents(Lorg/apache/hadoop/mapreduce/JobID;II)[Lorg/apache/hadoop/mapreduce/TaskCompletionEvent;	
org.apache.hadoop.mapred.YARNRunner.getTaskDiagnostics(Lorg/apache/hadoop/mapreduce/TaskAttemptID;)[Ljava/lang/String;	org.apache.hadoop.mapreduce.protocol.ClientProtocol.getTaskDiagnostics(Lorg/apache/hadoop/mapreduce/TaskAttemptID;)[Ljava/lang/String;	
org.apache.hadoop.mapred.YARNRunner.getTaskReports(Lorg/apache/hadoop/mapreduce/JobID;Lorg/apache/hadoop/mapreduce/TaskType;)[Lorg/apache/hadoop/mapreduce/TaskReport;	org.apache.hadoop.mapreduce.protocol.ClientProtocol.getTaskReports(Lorg/apache/hadoop/mapreduce/JobID;Lorg/apache/hadoop/mapreduce/TaskType;)[Lorg/apache/hadoop/mapreduce/TaskReport;	
org.apache.hadoop.mapred.YARNRunner.killJob(Lorg/apache/hadoop/mapreduce/JobID;)V	org.apache.hadoop.mapreduce.protocol.ClientProtocol.killJob(Lorg/apache/hadoop/mapreduce/JobID;)V	
org.apache.hadoop.mapred.YARNRunner.killTask(Lorg/apache/hadoop/mapreduce/TaskAttemptID;Z)Z	org.apache.hadoop.mapreduce.protocol.ClientProtocol.killTask(Lorg/apache/hadoop/mapreduce/TaskAttemptID;Z)Z	
org.apache.hadoop.mapred.YARNRunner.getQueueAdmins(Ljava/lang/String;)Lorg/apache/hadoop/security/authorize/AccessControlList;	org.apache.hadoop.mapreduce.protocol.ClientProtocol.getQueueAdmins(Ljava/lang/String;)Lorg/apache/hadoop/security/authorize/AccessControlList;	
org.apache.hadoop.mapred.YARNRunner.getJobTrackerStatus()Lorg/apache/hadoop/mapreduce/Cluster$JobTrackerStatus;	org.apache.hadoop.mapreduce.protocol.ClientProtocol.getJobTrackerStatus()Lorg/apache/hadoop/mapreduce/Cluster$JobTrackerStatus;	
org.apache.hadoop.mapred.YARNRunner.getLogFileParams(Lorg/apache/hadoop/mapreduce/JobID;Lorg/apache/hadoop/mapreduce/TaskAttemptID;)Lorg/apache/hadoop/mapreduce/v2/LogParams;	org.apache.hadoop.mapreduce.protocol.ClientProtocol.getLogFileParams(Lorg/apache/hadoop/mapreduce/JobID;Lorg/apache/hadoop/mapreduce/TaskAttemptID;)Lorg/apache/hadoop/mapreduce/v2/LogParams;	
org.apache.hadoop.mapred.LocalJobRunner$Job.shuffleError(Lorg/apache/hadoop/mapred/TaskAttemptID;Ljava/lang/String;)V	org.apache.hadoop.mapred.TaskUmbilicalProtocol.shuffleError(Lorg/apache/hadoop/mapred/TaskAttemptID;Ljava/lang/String;)V	
org.apache.hadoop.mapred.TaskAttemptListenerImpl.canCommit(Lorg/apache/hadoop/mapred/TaskAttemptID;Ljava/lang/String;)Z	org.apache.hadoop.mapred.TaskUmbilicalProtocol.canCommit(Lorg/apache/hadoop/mapred/TaskAttemptID;Ljava/lang/String;)Z	
org.apache.hadoop.mapred.TaskAttemptListenerImpl.commitPending(Lorg/apache/hadoop/mapred/TaskAttemptID;Lorg/apache/hadoop/mapred/TaskStatus;Ljava/lang/String;)V	org.apache.hadoop.mapred.TaskUmbilicalProtocol.commitPending(Lorg/apache/hadoop/mapred/TaskAttemptID;Lorg/apache/hadoop/mapred/TaskStatus;Ljava/lang/String;)V	
org.apache.hadoop.mapred.TaskAttemptListenerImpl.done(Lorg/apache/hadoop/mapred/TaskAttemptID;Ljava/lang/String;)V	org.apache.hadoop.mapred.TaskUmbilicalProtocol.done(Lorg/apache/hadoop/mapred/TaskAttemptID;Ljava/lang/String;)V	
org.apache.hadoop.mapred.TaskAttemptListenerImpl.fatalError(Lorg/apache/hadoop/mapred/TaskAttemptID;Ljava/lang/String;Ljava/lang/String;)V	org.apache.hadoop.mapred.TaskUmbilicalProtocol.fatalError(Lorg/apache/hadoop/mapred/TaskAttemptID;Ljava/lang/String;Ljava/lang/String;)V	
org.apache.hadoop.mapred.TaskAttemptListenerImpl.fsError(Lorg/apache/hadoop/mapred/TaskAttemptID;Ljava/lang/String;Ljava/lang/String;)V	org.apache.hadoop.mapred.TaskUmbilicalProtocol.fsError(Lorg/apache/hadoop/mapred/TaskAttemptID;Ljava/lang/String;Ljava/lang/String;)V	
org.apache.hadoop.mapred.TaskAttemptListenerImpl.shuffleError(Lorg/apache/hadoop/mapred/TaskAttemptID;Ljava/lang/String;)V	org.apache.hadoop.mapred.TaskUmbilicalProtocol.shuffleError(Lorg/apache/hadoop/mapred/TaskAttemptID;Ljava/lang/String;)V	
org.apache.hadoop.mapred.TaskAttemptListenerImpl.getMapCompletionEvents(Lorg/apache/hadoop/mapred/JobID;IILorg/apache/hadoop/mapred/TaskAttemptID;Ljava/lang/String;)Lorg/apache/hadoop/mapred/MapTaskCompletionEventsUpdate;	org.apache.hadoop.mapred.TaskUmbilicalProtocol.getMapCompletionEvents(Lorg/apache/hadoop/mapred/JobID;IILorg/apache/hadoop/mapred/TaskAttemptID;Ljava/lang/String;)Lorg/apache/hadoop/mapred/MapTaskCompletionEventsUpdate;	
org.apache.hadoop.mapred.TaskAttemptListenerImpl.ping(Lorg/apache/hadoop/mapred/TaskAttemptID;Ljava/lang/String;)Z	org.apache.hadoop.mapred.TaskUmbilicalProtocol.ping(Lorg/apache/hadoop/mapred/TaskAttemptID;Ljava/lang/String;)Z	
org.apache.hadoop.mapred.TaskAttemptListenerImpl.reportDiagnosticInfo(Lorg/apache/hadoop/mapred/TaskAttemptID;Ljava/lang/String;Ljava/lang/String;)V	org.apache.hadoop.mapred.TaskUmbilicalProtocol.reportDiagnosticInfo(Lorg/apache/hadoop/mapred/TaskAttemptID;Ljava/lang/String;Ljava/lang/String;)V	
org.apache.hadoop.mapred.TaskAttemptListenerImpl.statusUpdate(Lorg/apache/hadoop/mapred/TaskAttemptID;Lorg/apache/hadoop/mapred/TaskStatus;Ljava/lang/String;)Z	org.apache.hadoop.mapred.TaskUmbilicalProtocol.statusUpdate(Lorg/apache/hadoop/mapred/TaskAttemptID;Lorg/apache/hadoop/mapred/TaskStatus;Ljava/lang/String;)Z	
org.apache.hadoop.mapred.TaskAttemptListenerImpl.reportNextRecordRange(Lorg/apache/hadoop/mapred/TaskAttemptID;Lorg/apache/hadoop/mapred/SortedRanges$Range;Ljava/lang/String;)V	org.apache.hadoop.mapred.TaskUmbilicalProtocol.reportNextRecordRange(Lorg/apache/hadoop/mapred/TaskAttemptID;Lorg/apache/hadoop/mapred/SortedRanges$Range;Ljava/lang/String;)V	
org.apache.hadoop.mapred.TaskAttemptListenerImpl.getTask(Lorg/apache/hadoop/mapred/JvmContext;Ljava/lang/String;)Lorg/apache/hadoop/mapred/JvmTask;	org.apache.hadoop.mapred.TaskUmbilicalProtocol.getTask(Lorg/apache/hadoop/mapred/JvmContext;Ljava/lang/String;)Lorg/apache/hadoop/mapred/JvmTask;	
